..............................
..............................
..............................
..............................
..............................
..............................
..............................
..............................
.......g......................
......###.....................
..............................
#..###...###..................
..............................
1.......................A....x
##############################
